NO ./img/red.png
SO ./img/green.png
WE ./img/blue.png
EA ./img/yellow.png
F 220,100,0
C 225,30,0

11111
1S001
10101
10001
11111
