NO               ./img/wall.jpg

            SO ./img/wall.jpg

WE ./img/wall.jpg

EA ./img/wall.jpg
F 220,100,0
C 225,30,0




111111111111110011111111
1000000000110000000000001
1011000001110000000000001
1001000000000000000000001
1111111110110000011111111
1000011000001110111111111111
1111011111111111001111000011
11110111111111 11101010011
110000001101011111100000011
1000000000000000110000001001
10000000000000001101010010001
11000001110101011111011110N0111
11110111 1110101 101111010001
11111111 1111111 111111111111

